NO ./textures/north.xpm
SO ./textures/south.xpm
WE ./textures/west.xpm
EA ./textures/east.xpm

F 41,49,51
C 225,255,255

1111111100011111111111111
10000000000S0000000000001
1000000000000000000000001
1000000000000000000000001
1000000000000000000000001
1111100111111111100111111
1000000000011000000000001
1000000000011000000000001
10000000000110000000000011111     11111111110011111
10000000000110000000000000001     10000000000000001
100000000001100000000000000011111110000000000000001
100000000001100000000000000000000000000000000000001
100000000001100000000000000000000000000000000000001
100000000001111111111111111111111111111110011111111
100000000000000000000000000011000000000000000000001
100000000000000000000000000011000000000000000000001
100000000000000000000000000011000000000000000000001
100000000000000000000000000011000000000000000000001
111111111111111000000011111111111111111111111111111
