SO ./textures/south.xpm
WE ./textures/west.xpm
EA ./textures/east.xpm

F 41,49,51
C 225,255,255

1111111111111111111111111111111
100000000000000000000000011111
100000000011100000N0000000001
1000000000000000000000000001
111111111111111111111111111111
111111111111111111111111111111
100000000000000000000000000001
1111111111111111111111111111111
